2 13 31
###############################
#p    * **    *   3   3   *   #
# # # #w# # # # # # #b# # # # #
#      ** * *  *   * ** 3 *   #
# # # # # #*# # # # # # #*# # #
#*   F *    *b* *   **        #
# # # # # # # # # # # # # #*# #
#*   *     *   b    *    **  3#
# #s# # #b#*#*#*# # #1# # #*# #
#*       * 3 *2*    *   *     #
# # # # # # # # # # # #*# # #*#
#* * f * **    ** ***     1  x#
###############################