4 13 31
###############################
#p   *  **    *   *     **  *2#
# # # #*# # # # # # # # # # #*#
#*     ** * *  *   * *  2 *   #
# #*# # # #*# # # # # # #*# # #
#*   * * w  *** * * **  b     #
# # # # # # # # # # # # # #*# #
#    *     *  1     *    **  3#
# #*# # #*#*#*#*# # #1# # #*# #
#   2    *   *s*    * 4 *     #
#*# # # # # # # # # # #*# # #*#
# *    * **    ** *f*     1   #
###############################