3 13 31
###############################
#p   *  **    *   2     *  4  #
# # # #*# # # # # # # # # # # #
#*   *  * * *  *   * ** 3 *   #
# # # # # #*# # # # # # #*# # #
#*   *s* f  *b* * * **        #
# # # # # # # # #x# # # # #*# #
#    *     *        *    **  3#
# #*# # #*#*#*#*# # #1# # #*# #
#        *   * *    * 2 *     #
#*# # # # #F# # # # # #*# # #*#
# *    * **    f* ***     1   #
###############################