5 13 31
###############################
#p  b  * * *  f  * * s * * *  #
# # # # # # # # # # # # # # # #
#     *   *   w   3    b * b  #
# # # # # # # # # # # # # # # #
#     *  2    F  *f   4       #
# # # # # # # # # # # # # # # #
#    2     s   x   3  s  f    #
#*# # # # # # # # # # # # # # #
#    * * *   2    b    4      #
#*# # # # # # # # # # # # # # #
#     1    f  2       3       #
###############################