2 13 31
###############################
#p    * **    *   3   4   *   #
# # # #w# # # # # # #b# # # # #
#      ** * *  *   * ** 3 *   #
# # # # # #*# # # # # # #*# # #
#*   F *    *b* *   **        #
# # # # # # # # # # # # # #*# #
#*   *     *   b    *    **  3#
# #s# # #b#*#*#*# # #1# # #*# #
#*       * 4 *2*    *   *     #
# # # # # # # # # # # #*# # #*#
#* * f * **    ** ***     1  x#
###############################