3 13 31
###############################
#p   *  **    *   2     *  4  #
# # # #*# # # # # # # # # # # #
#*   *  * * *  *   * ** 3 *   #
# # # # # #*# # # # # # #*# # #
#*   *s* f  *b* * * **        #
# # # # # # # # #x# # # # #*# #
#    *     *        *    **  3#
# #*# # #*#*#*#*# # #1# # #*# #
#        * 4 * *    * 2 *     #
#*# # # # #F# # # # # #*# # #*#
# *    * **  3 f* ***     1   #
###############################